Genesis|Genesis
Exodus|Exodo
Leviticus|Levitico
Numbers|Bilang
Deuteronomy|Deuteronomio
Joshua|Josue
Judges|Hukom
Ruth|Ruth
I Samuel|1 Samuel
II Samuel|2 Samuel
I Kings|1 Hari
II Kings|2 Hari
I Chronicles|1 Cronica
II Chronicles|2 Cronica
Ezra|Ezra
Nehemiah|Nehemias
Esther|Esther
Job|Job
Psalms|Awit
Proverbs|Kawikaan
Ecclesiastes|Eclesiastes
Song of Solomon|Awit ni Solomon
Isaiah|Isaias
Jeremiah|Jeremias
Lamentations|Panaghoy
Ezekiel|Ezekiel
Daniel|Daniel
Hosea|Oseas
Joel|Joel
Amos|Amos
Obadiah|Obadias
Jonah|Jonas
Micah|Mikas
Nahum|Nahum
Habakkuk|Habakuk
Zephaniah|Zefanias
Haggai|Hagai
Zechariah|Zacarias
Malachi|Malakias
Matthew|Mateo
Mark|Marcos
Luke|Lucas
John|Juan
Acts|Gawa
Romans|Roma
I Corinthians|1 Corinto
II Corinthians|2 Corinto
Galatians|Galacia
Ephesians|Efeso
Philippians|Filipos
Colossians|Colosas
I Thessalonians|1 Tesalonica
II Thessalonians|2 Tesalonica
I Timothy|1 Timoteo
II Timothy|3 Timoteo
Titus|Tito
Philemon|Filemon
Hebrews|Hebreo
James|Santiago
I Peter|1 Pedro
II Peter|2 Pedro
I John|1 Juan
II John|2 Juan
III John|3 Juan
Jude|Judas
Revelation|Apocalipsis
